########################### ################## ##################
                          #                   z#
                          #                   z#
                          #                   z#
                          #                   z#
                          #                   z#
                          #                   z#
                          #                   z#
                          #                 # z#
                          #             ## ## z#
                          #           ###     z#
                          #         ##       zz#
                          #        #         zz#
                          ################v#####                          